WWWWWWWWWWWWWWWW
W     WWW      W
W P    WW G    W
W C     W      W
W              W
W            C W
W G       WWWWCW
W         W    W
W         W    W
W         W   GW
WWWWWWWWWWWWWWWW