WWWWWW
W C GW
W P  W
W  CGW
WWWWWW