WWWWWWWWWWWWWWWW
W P     G      W
W      C       W
W    G     C   W
W      CG      W
WWWWWWWWWWWWWWWW