WWWWWWWWWWWWWWWW
W P     G      W
W      C       W
W   C          W
WWWWWWW WWWWWWWW
W              W
W    G         W
W      CG      W
WWWWWWWWWWWWWWWW