WWWWWWWWWWWWWWWW
W         W    W
W P     G      W
W   W   C  W   W
W      W       W
W   W       C  W
W    G     W   W
W    W   W     W
W      CG W    W
W   W        W W
WWWWWWWWWWWWWWWW