WWWWWWWWWWWWWWWW
W              W
W P     G      W
W      C       W
W              W
W          C   W
W    G         W
W              W
W      CG      W
W              W
WWWWWWWWWWWWWWWW