WWWWWWW
W  W  W
W WGW W
W  C  W
W  P  W
WWWWWWW